




    ===========================================================================================================================
    ===========                                                                                                     ===========
    =========                                                                                                         =========
    =======                                                                                                             =======
    =====                                                                                                                 =====
    ===                                                                                                                     ===
    =                                                                                                                         =
    =                                                                                                                         =
    =                                                                                                                         =
    =                                                                                                                         =
    =                                                                                                                         =
    =                                                                                                                         =
    =                        ==========================================================================                       =
    =                        ==========================================================================                       =
    =                                                                                                                         =
    =                                                                                                                         =
    =                                                                                                                         =
    =                                                                                                                         =
    =                                                                                                                         =
    =                                                                                                                         =
    =                                                                                                                         =
    =                                                                                                                         =
    =                                                                                                                         =
    =                                                                                                                         =
    =                                                                                                                         =
    =                                                                                                                         =
    =                                                                                                                         =
    =                                                                                                                         =
    =                                                                                                                         =
    =                                                                                                                         =
    =                                                                                                                         =
    =                                                                                                                         =
    =                                                                                                                         =
    =                        ==========================================================================                       =
    =                        ==========================================================================                       =
    =                                                                                                                         =
    =                                                                                                                         =
    =                                                                                                                         =
    =                                                                                                                         =
    =                                                                                                                         =
    ===                                                                                                                     ===
    =====                                                                                                                 =====
    =======                                                                                                             =======
    =========                                                                                                         =========
    ===========                                                                                                     ===========
    ===========================================================================================================================


