




    ===========================================================================================================================
    =                                                                                                                         =
    =                                                                                                                         =
    =                                                                                                                         =
    =                                                                                                                         =
    =                                                                                                                         =
    =                                                                                                                         =
    =                                                                                                                         =
    =                                                                                                                         =
    =                                                                                                                         =
    =                                                                                                                         =
    =                                                                                                                         =
    =                        ==========================================================================                       =
    =                        ==========================================================================                       =
    =                                                                                                                         =
    =                                                                                                                         =
    =                                                                                                                         =
    =                                                                                                                         =
    =                                                                                                                         =
    =                                                                                                                         =
    =                                                                                                                         =
    =                                                                                                                         =
    =                                                                                                                         =
    =                                                                                                                         =
    =                                                                                                                         =
    =                                                                                                                         =
    =                                                                                                                         =
    =                                                                                                                         =
    =                                                                                                                         =
    =                                                                                                                         =
    =                                                                                                                         =
    =                                                                                                                         =
    =                                                                                                                         =
    =                        ==========================================================================                       =
    =                        ==========================================================================                       =
    =                                                                                                                         =
    =                                                                                                                         =
    =                                                                                                                         =
    =                                                                                                                         =
    =                                                                                                                         =
    =                                                                                                                         =
    =                                                                                                                         =
    =                                                                                                                         =
    =                                                                                                                         =
    =                                                                                                                         =
    ===========================================================================================================================


